11111111111
10C10000001
10010000001
10000000E01
100000P0001
10000000001
10000000001
11111111111
