111111111
1E00000C1
10B0000P1
111111111