111111111
1000000C1
1000000P1
111111111