11111111
1E00000C1
1000000P1
111111111