111111111111111111
1000000P0000000001
100000C00000C00001
1E0000000000000001
111111111111111111
