111111111111111111
1000000P0000000001
111000C00000C00001
1E1000000000000001
111111111111111111
