11111111111
10C10000001
10010000001
10000011111
100000PE0C1
10000011111
100C0000001
11111111111
