111111111111111111111111111111111111111111111111111111111111111111111111111111111111111111111111
100000000000000000000000000000000000000000000000000000000000000000000000000000000000000000000001
1P0000000000000000000000000000000000C0000000000000000000000000000E000000000000000000000000000001
111111111111111111111111111111111111111111111111111111111111111111111111111111111111111111111111