111111111
100000001
100B00001
111111
