111111111
1E0000001
1000000P1
111111111
