1111111111111
1E00000C000011
100000000000011
1000000P111111
111111111
