111111111
1E00000C1
100000001
111111111
