111111110
1E00000C0
1000000P0
111110111
