1111111
1000011
100C011
1E00P01
1111111
