WE assets/wood.png
SO assets/grey.png
EA assets/brick.png
NO assets/blue.png

F 146, 109, 39
C 135, 206,

1111111
100S001
1111111







