WE assets/wood.png
SO assets/grey.png
EA assets/brick.png
NO assets/blue.png

F 146, 109, 39
C 135, 206, 235

1111111
100S000
1111111







